bgnqrss : gns, grs, nbg, qrs
chkuuvx : huck, huk, khu
efsvvvy : efs, fey, yes, sey, sye
aeeioou : eau, iao, iou, oie, oui
ffjnquv : fun, jun, juv
nnnpqrt : prn, qtr, rpt, trp
aaeeeqy : aeq, aye, eye, yea, yee
lnnsstz : lst, slt, tln, tss
bkkmrsz : bks, krs, mks, mrs, rms
flllntt : fll, tln, tnt
aaeeeio : iao, ieee, oie
bhlrrrv : brl, brr, brrr, lhb, rhb
eeeguux : euge, gee, gue
aaaeeiy : aaa, aye, eye, yea, yee
aaaeeuz : aaa, eau, zea, zee
deeeexx : dee, dex, exede, xed
eeeeiio : ieee, oie, oii
aaaaeiy : aaa, aye, yea
fhlnttv : fth, nth, tln, tnt
iiiiirw : iii, iiwi, wir
bcnnrsw : crs, csw, scr
eeeoopq : epee, ope, pee, poe
aaaaiou : aaa, iao, iou, oui
dfirrrr : dif, dir, fid, fir, rid
bllrrrx : brl, brr, brrr, llb
aaeeiio : iao, oie, oii
cnppsvz : cps, csp, pps, spp, svc
moqquwx : mou, mow, mux, quo
aaeeeix : aix, axe, ieee
ajoooxy : yao, yox, jay, joy, oxy
cceeiii : cee, cie, ecce, ice, iii
aaeiouu : eau, iao, iou, oie, oui
aaeiiju : eau, jai, jeu, uji
jmnpqtv : jnt, mtn, pmt, pvt, tpm
eeeekqu : eke, kee, kue, que, uke
aeeeioo : iao, ieee, oie
beeeiii : bee, ieee, iii
iillwww : ill, lwl, will, willi, wiwi
djllprr : dlr, pdl, rld
eeiiiou : iii, iou, oie, oii, oui
deeeeet : dee, det, ted, tee, teed
eeeeiiy : eye, yee, ieee
eeepuxz : epee, exp, pee, zee, zep
gggiiil : gig, gigi, gil, iii, lig
aeeiioo : iao, oie, oii
ghnnqrs : gns, grs, hrs, qrs, shr
chllnvx : chn, hcl, xcl
dnsttwz : dwt, std, tnt, tst
dnsstvx : sds, std, tss, vss
lmnqssw : lwm, msl, mss, sml
jjoopwx : jow, pow, pox, woo, wop
clllmvw : cml, cwm, lcm, lwl, lwm
eeiiipu : epi, iii, pee, pie, piu
fgnnssv : fgn, gns, svgs, vss
dfgqsxz : gds, sfz, sgd, sqd
eeeioou : ieee, iou, oie, oui
aeeiioq : aeq, iao, oie, oii
eeevvvw : eve, ewe, vee, wee, weve
gghnnrt : ggr, hgt, nth, tgn, tng
eiioooo : oie, oii, oooo
eeooouz : ooze, ouze, ouzo, zee, zoo
eeeiiit : ieee, iii, tee, tie
eeoouuz : ooze, ouze, ouzo, zee, zoo
eeoouuw : ewe, owe, wee, woe, woo
bhhrtwx : hwt, rhb, rtw, whr
aaeeiou : eau, iao, iou, oie, oui
eeeeiim : eme, ieee, imi, mee
aquuwww : qua, quaw, waw
eeeegiu : euge, gee, gie, gue, ieee
eeegwwx : ewe, gee, wee
aaaaceq : aaa, ace, aeq
bfnrsvw : bnf, bsf, frs, rfb, rfs
fhhsttt : fth, hts, shh, sht, tst
cdhlqvw : hcl, hdlc, hld, lcd, lhd
jnrwwxy : jynx, rwy, wyn, wry
cgmsxzz : cgm, cgs, mcg, msg
ccjjmov : ccm, com, moc, voc
iiiioor : iii, oii, rio, roi, roo
fgghrvw : ggr, grf, whf, whr
nrrrtxy : rynt, tyr, tyrr, try
eequuxz : que, queue, zee
aaaaaho : aaa, aah, aha, aho, hao
gjnstvv : gns, jnt, stg, tgn, tng
jllnqwy : lyn, llyn, lwl, wyn
norrrrv : nor, nov, ron, von
hnprwxx : phr, prn, pwr, whr
gggivwy : gig, ivy, wig, wiggy
bhuvvvy : buy, hub, hvy, yuh
eeiioou : iou, oie, oii, oui
eiiiijn : iii, jen, jin, nei
aaceqqz : ace, aeq, caza, zac, zea
aeioouu : eau, iao, iou, oie, oui
eeiouuz : iou, oie, oui, ouze, zee
bglmrrz : brl, brr, glb, grr, mgr
ioooopv : oooo, poi, vip
eeeeguw : euge, ewe, gee, gue, wee
aaaaiio : aaa, iao, oii
aeeeeiz : ieee, zea, zee
aooouuv : avo, ova, uva, vau
eeeiiuw : ewe, ieee, wee, wei
eejkkqx : eke, jee, kee, keek, kex
fjjluxy : fly, flu, flux, july, lux
imoqqvv : moi, qqv, vim, vivo
aaeiiiy : aye, yea, iii
lllntvy : lyn, llyn, tln
hhjkkst : hts, shh, sht, stk, tsk
hkmnqvy : hymn, hny, hvy
bpprwxz : pbx, ppb, ppr, prp, pwr
eeeoooy : eye, yee, yeo, yoe
eeeiioo : ieee, oie, oii
eioooou : iou, oie, oooo, oui
iioouuw : iou, oii, oui, woo
ghhpqrr : gph, grr, phr
bcclrvx : brl, clr, crc, crl, xcl
eiiuuuv : ive, vei, vie, vii
knuwyyz : yuk, yun, kyu, wyn, wun
ooorrrs : oos, ors, roo, ros
eeeeeko : eke, kee, oke, okee
eeiioux : iou, oie, oii, oui, xii
eeiiqux : que, quei, qui, xii
ejkoooq : ejoo, joe, joke, jook, oke
blnnnps : bls, bps, lbs, spl
cdknqsv : csk, dks, sqd, svc
aaaaijo : aaa, iao, ijo, jai, jiao
chnnsvz : chn, chs, sch, svc
aaaiiou : aaa, iao, iou, oii, oui
jlmnqtz : jnt, mtn, tln
dknnrrs : dks, dsr, krs, rnd
aaaiuyy : aaa, ayu, yay, yaya
hhkprvw : kph, kwhr, phr, pwr, whr
ipqyyzz : yip, izzy, pizz, zip
bknrtvw : bkt, bvt, rtw, wrnt
aioouuu : iao, iou, oui
iiqrrux : qui, rix, rux, uri, xii
beeeouu : bee, boe, eboe, obe
cdlnnpz : cpd, cpl, lcd, pdl, pdn
bcnrsvw : crs, csw, scr, svc
iinuuyy : yin, yun, uni
dflnnrr : dlr, fld, lnr, rld, rnd
eeoouuv : eve, evoe, vee, voe
eeeeetu : tee, tue, ute
aeeeegx : age, agee, axe, gae, gee
lrrttwx : ltr, rtw, tlr, trt, txt
aacjooo : coo, cooja, oca
ccjjooz : coco, coo, coz, zocco, zoo
hhiiiuy : huh, hui, ihi, iii, yuh
bbfhlmn : bbl, bnf, flb, lbf, lhb
bhkmrrz : brr, mhz, rhb
fhiiiqy : fiqh, ihi, iii
deeeeeo : dee, doe, edo, ode
aaeiioo : iao, oie, oii
aeiiooo : iao, oie, oii
cgiuwwy : cig, guy, icy, yug, wig
hnqquuy : hny, hun, yuh, yun
nnoqszz : non, nos, ons, ozs, son
glnnrrs : gns, grr, grs, lnr
gklrtzz : glt, kgr, ltr, tlr
gkmsvwz : mks, msg, wmk
inqrrrv : inv, rin, riv, vin
bdjnnrw : dbrn, jnd, rnd, rwd
eeeioqz : ieee, oie, zee
anqqqvv : avn, nav, qqv, van, vav
bcccgkt : bkg, bkt, ctg, gtc, tck
blrvxyy : byrl, brl, rly
bcgllnn : glb, llb, nbg
mmsttwx : mts, mtx, stm, tst, txt
nqqruvv : qqv, run, urn
eeuuuwz : ewe, wee, wuzu, zee
hijkrrr : hir, irk, khi, khir, rik
bbccgux : bub, bug, cub, ubc
eeeoooz : ooze, zee, zoo
aaaejou : aaa, eau, jeu, joe
aeeeiij : ajee, ieee, jai, jee
glmwxxz : lwm, lxx, mlx
eeeijxz : ieee, jee, jeez, zee
hnntttw : hwt, nth, tnt
lmmnnrt : lnr, ltr, mtn, tln, tlr
eeeoovv : eve, evoe, vee, voe
bklrrrr : bklr, blk, brl, brr, brrr
cegjqvw : evg, jeg, jew, veg, wjc
eiuuuvy : ive, ivy, vei, vie
eiiiiir : eir, iii, ire, rei, rie
bdmnsvw : bds, dbms, mbd
aooooos : oooo, oos, sao
gjnpprr : grr, ppr, prn, prp
bkmqswx : bks, bxs, mks, wmk
bcjrsvw : crs, csw, scr, svc, wjc
eeeeiou : ieee, iou, oie, oui
aeiiooq : aeq, iao, oie, oii
cdgnqvy : cdg, dyn, gcd, gyn
ccfmnrv : ccm, cfm, crc, mcf, mfr
glpqtvz : glt, ptg, pvt
fiqrrww : fir, wir, wirr
bjjllnt : btl, jnt, llb, tln
dffstvw : dft, dwt, fwd, std
llmnnrt : lnr, ltr, mtn, tln, tlr
aaaeixz : aaa, aix, axe, zax, zea
abeeeee : abe, bae, bea, bee
lnnnptt : ptt, tln, tnt
aeeeioq : aeq, iao, ieee, oie
eiiiinu : iii, nei, niue, uni, unie
egoouuu : ego, geo, goo, gou, gue
nprrtvv : prn, pvt, rpt, trp
aaeeoqx : aeq, axe, oxea
aaiiioo : iao, iii, oii
bffhltz : btl, flb, fth, lbf, lhb
aeeiiio : iao, iii, oie, oii
hkllnqt : hlqn, kln, nth, tln
cklnnnr : clk, clr, crl, kln, lnr
hhlnprv : lnr, phr, prn
flmnqyz : fly, lym, lyn
eeeiijz : ieee, jee, jeez, zee
aaeejou : ajee, eau, jee, jeu, joe
jlnuuww : jun, nul, ulu, unl, wun
ciikwww : ckw, kiwi, wick, wiwi
kmrrrty : myrt, mkt, tyr, tyrr, try
goooouw : goo, gou, oooo, wog, woo
ceeeeuy : cee, cue, ecu, eye, yee
iqruuvv : qui, riv, uri, uru
eooooqy : yeo, yoe, oooo
bgnwyzz : gyn, nbg, wyn
ffhlrvy : fly, fry, hvy, rly
aeeejox : ajee, axe, jee, joe, oxea
aeeeiio : iao, ieee, oie, oii
eiinuuu : nei, niue, uni, unie
cnnptvz : cpt, ctn, pct, pvt
eeeiiou : ieee, iou, oie, oii, oui
aeeooux : aux, axe, eau, eaux, oxea
ajoooov : avo, jova, oooo, ova
dghqrvy : dry, gry, hyd, hvy, rhd
iiiilnz : iii, liin, lin, liz, nil
aacgggx : aga, agag, cag, gag, gaga
llnnrrt : lnr, ltr, tln, tlr
aiiiiin : ain, ani, ian, iii, inia
aeeeiix : aix, axe, ieee, ixia, xii
fggiqvy : fig, figgy, gif, gig, ivy
gnntttv : gtt, tgn, tgt, tng, tnt
aeeioox : aix, axe, iao, oie, oxea
hiiiiny : hin, hny, ihi, iii, yin
fhlmqrw : lwm, mfr, whf, whr
eeiiioo : iii, oie, oii
eeiouuu : iou, oie, oui
cltwwyz : cyl, cly, cwt, lyc
apqqqrr : apr, arr, par, parr, rap
iooooou : iou, oooo, oui
ciiiquy : icy, iii, qui
eeeguuu : euge, gee, gue
ghnnrtv : hgt, nth, tgn, tng
efiiiiu : fei, feu, fie, ife, iii
iiruuvy : ivy, riv, uri, uru, vii
aaooouv : ava, avo, ova, uva, vau
elllnnx : ell, enl, len, lex, nell
aaaeeeh : aaa, aah, aha, hae, hee
ggrtttw : ggr, gtt, rtw, tgt, trt
ijnnpqq : inn, jin, jinn, nip, pin
eeeiiqt : ieee, tee, tie
nqrssyy : yrs, qrs, syn, syr, sny
aaaaoqu : aaa, aqua, aquo, qua, quo
aaeijqz : aeq, jai, zea
mmmuwwz : mum, mumm, umm
aeeeeij : ajee, ieee, jai, jee
aeiiioo : iao, iii, oie, oii
cgmmrvz : cgm, mcg, mgr
aaiioou : iao, iou, oii, oui
knnssvy : syn, sky, skys, sny, vss
klnnnps : kln, pks, spl
beeevzz : bee, beeve, eve, vee, zee
eeeeouw : ewe, owe, wee, woe
loqrrrx : loq, lor, lox, orl, rox
aeiiiio : iao, iii, oie, oii
fiiiiiv : iii, vii, viii
eeeiuyy : eye, eyey, yee, ieee
bjjjouu : job, juju, obj
crrsssv : crs, rcvr, scr, svc, vss
aeioooo : iao, oie, oooo
diiiijo : ido, iii, ijo, oii
hhiiilr : hili, hir, ihi, iii, lir
eeeouww : ewe, owe, wee, woe, wow
eoowwww : owe, woe, woo, wow
dlrsxxz : dlr, dsr, lxx, rld, sld
eeeeoot : oot, oto, tee, toe, too
aeiooou : eau, iao, iou, oie, oui
bbennqz : ben, benn, ebb, neb, zen
iirruuy : yirr, ruru, uri, uru
aaaioou : aaa, iao, iou, oui
ddjmssv : jms, mss, sds, vss
aaaceex : aaa, ace, axe, cee, exec
fhhlptx : fth, pfx, pht, plf, tph
hhmnqtv : mtn, nth, tmh
gnnnssv : gns, svgs, vss
cddttwz : cwt, ddt, dtd, dwt
aaeiiio : iao, iii, oie, oii
aeiiiuz : eau, iii, zea
deeeeoo : dee, doe, doo, edo, ode
iiisuyy : iii, yis, yus, sui
aaaabuu : aaa, aba, abu, baa
aaeeiuz : eau, zea, zee
llptwwz : lwl, lwp, pwt, twp
lmnrryy : lym, lyn, lnr, rly
fllnsst : fll, lst, slt, tln, tss
ddfhquz : dhu, dud, fud, hud
aaaaeio : aaa, iao, oie
ghhssvw : shh, svgs, vss, whs
ejjuuvy : jeu, juju, juv
aaaaakp : aaa, aka, apa, kapa
ceeeeoo : cee, coe, coo, cooee, eco
ccfggtw : ccw, ctf, ctg, cwt, gtc
hiilrrr : hili, hir, ihi, lir
bgjjllr : brl, glb, llb
epquuuw : pew, que, wup
ciijmqx : imi, jim, mix, xii
dlmrwwz : dlr, lwm, rld, rwd
iiiioop : iii, oii, poi
bgggmns : gns, msg, nbg
chruuuv : cru, cur, uhuru, uru, urucu
hiiilrr : hili, hir, ihi, iii, lir
bfghmmw : mfg, mhg, mmf, whf
gjmmttt : gtt, mgt, mtg, tgt
eiiooou : iou, oie, oii, oui
ggglrtv : ggr, glt, ltr, tlr
clnnttw : ctn, cwt, tln, tnt
dhkntww : dwt, hwt, nth
dfflqtt : dft, fld, qtd
ffglppw : lwp, pfg, plf, ppl
aacouuu : auca, oca, uca
eeeegqv : eve, evg, gee, vee, veg
iiruuux : rix, rux, uri, uru, xii
aaooouy : ayu, yao, you
lssttwz : lst, slt, tss, tst
cceiiuz : cie, cize, cue, ecu, ice
klmrrrt : ltr, mkt, tlr
bcmnrry : brr, cry, myc
hhiiiio : hoi, ihi, iii, oii
hinnnvv : hin, inn, inv, vin
bdqrttv : bvt, qtd, qtr, tdr, trt
hhiivvy : hvy, ihi, ivy, vii
ffnnrtz : frt, rfz, tfr, trf
mnnrvwy : rwy, wyn, wynn, wry
iipqwyz : yip, wiz, zip
ggstttw : gtt, stg, tgt, tst
eeeiuxy : eye, yee, ieee, yex
eeeegoo : ego, gee, geo, goo, ogee
bbfkmtz : bkt, fmt, mkt
aaaafox : aaa, fax, fox, oaf
fjklpyy : fly, kyl, plf, ply
fiijkvw : fiji, kif, kiwi, vii
eiiiooo : iii, oie, oii
knnrrst : krs, stk, str, trs, tsk
gghntvv : hgt, nth, tgn, tng
eeeiquu : ieee, que, quei, queue, qui
bcnqtwy : ctn, cwt, qty, wyn
aiijqyy : yay, jai, jay
eeeeiin : een, ieee, nee, nei
flnnsst : lst, slt, tln, tss
bdrrsvz : bds, brr, dsr
aiijooo : iao, ijo, jai, jiao, oii
cmnpqvw : cpm, cwm, pcm, wpm
bbcfjmr : bcf, cfm, mcf, mfr, rfb
aaiuxyy : ayu, aix, aux, yay, yaya
aaeeiij : ajee, jai, jee
aeeeiqz : aeq, ieee, zea, zee
nrruvww : run, urn, wun, wur
fjooopv : foo, fop, ofo, oof, poof
iiirrrs : iii, iris, irs, sir, sri
eeeeein : een, ieee, nee, nei
eiiiioo : iii, oie, oii
aiioqqy : iao, yao, iyo, yoi, oii
lnnrrtz : lnr, ltr, tln, tlr
gnrrrsv : gns, grr, grs
crrrtvw : ctr, cwt, rct, rcvr, rtw
aeeeeix : aix, axe, ieee
eeiooux : iou, oie, oui
cffuwxy : cuff, cuffy, fcy, wuff
eeegiix : gee, gie, ieee, xii
cnpqrry : cyp, cry, pyr, pry, prn
aaaafio : aaa, iao, iof, oaf
eiiiijl : eli, iii, ile, lei, lie
cgknqry : cry, gyn, gry, kgr
egooooq : ego, geo, goo, oooo
bbghqrr : brr, grr, rhb
ffjnnrt : frt, jnt, tfr, trf
bdlllnn : bdl, bld, dbl, llb
ggijqwx : gig, jig, wig
agiiiiy : agy, gay, yagi, iii
aaiiuwz : awa, iwa, wiz
iquuvxy : ivy, qui, xiv, xvi
aaaafiw : aaa, awa, iwa, waf, waif
bffnnrs : bnf, bsf, frs, rfb, rfs
iooopuu : iou, oui, piu, poi, upo
bbhrtwz : hwt, rhb, rtw, whr
aiiioqz : azo, iao, iii, oii, zoa
aaaeiyz : aaa, aye, yea, yez, zea
eiijjoz : ijo, joe, joie, oie, oii
eeeefuv : eve, fee, feu, vee
ggllrtv : ggr, glt, ltr, tlr
bgnrsvx : bxs, gns, grs, grx, nbg
lmnnttt : mtn, tln, tnt
aioooqz : azo, iao, oozoa, zoa, zoo
ggkrrsw : ggr, grr, grs, kgr, krs
aaeeeey : aye, eye, yea, yee
gjlrrwy : gry, grr, rly, rwy, wry
oosuuux : oos, sou, sox, suu, usu
aaajoqu : aaa, aqua, aquo, qua, quo
eeeeeit : ieee, tee, tie
hnouuuz : hon, hun, noh, nou, zho
aejjouu : eau, jeu, joe, juju
aaaeoox : aaa, axe, oxea
aaaeeio : aaa, iao, oie
aaaaacy : aaa, acy, cay
eoopuuv : ope, poe, poove, upo, voe
fhnnrsx : frs, hrs, rfs, shr
elnnnqw : enl, len, lew, new, wen
biivwwz : biz, vii, viz, wiwi, wiz
bdmmpqr : bdrm, mbd, mpb, pdq, rpm
iiooqqr : oii, rio, roi, roo
aeeejoo : ajee, ejoo, jee, joe
aaeeeiz : ieee, zea, zee
blmnttv : btl, bvt, mtn, tln, tnt
eeeeegi : gee, gie, ieee
eeeeuvw : eve, ewe, vee, wee, weve
eeeiiww : ewe, ieee, wee, wei, wiwi
ciioooo : coo, oii, oooo
aaaejjz : aaa, ajaja, zea
eeeiiio : ieee, iii, oie, oii
eeiiiin : een, iii, nee, nei
ddiiijk : did, iii, kid
dikvvwz : div, kid, viz, wid, wiz
hklquzz : huk, hulk, huzz, khu
aaaalqz : aaa, aal, ala, laz
ffghnvy : fgn, gyn, hny, hvy
cdhkqtv : qtd, tch, tck
hhmnssv : mss, shh, vss
bdgrtwz : dwt, gtd, rtw, rwd, tdr
aaeijqx : aeq, aix, ajax, axe, jai
cgjlnpw : cpl, jcl, lwp, wjc
bknrvwy : yrbk, rwy, wyn, wry
aeeefuu : auf, eau, fae, fee, feu
aaaagoq : aaa, aga, agao, ago, goa
cnqstxz : cst, ctn, cts, qts, sct
hlmqrtz : ltr, mhz, qtr, tlr, tmh
aaaouuy : aaa, ayu, yao, you
lmnnttz : mtn, tln, tnt
aaejooq : aeq, ejoo, joe
eiiiuuw : iii, iiwi, wei
ffiikuw : iff, kif, kiwi, kui, wuff
eioouxx : iou, oie, oui, xix, xxi
ckmnnnt : ctn, mkt, mtn, tck
bchknxx : bch, chn, hcb
aaijooo : iao, ijo, jai, jiao
llrrtwz : ltr, lwl, rtw, tlr
dlrrvwx : dlr, rld, rwd
klmrvyz : kyl, lym, rly
ajoqxxz : azo, azox, zax, zoa
aeeeeio : iao, ieee, oie
iiiijls : iii, isl, lis, sil
dprrsvv : dsp, dsr, prs, rps, rsvp
eeeooov : eve, evoe, vee, voe
ceeeeeo : cee, coe, eco
ggiiuuz : gig, gigi, gugu, guz, zig
ccjouux : cox, cuj, jocu
biimyyy : bim, ibm, imi, mib
jmooovx : joom, mojo, moo, moxo, vox
ciioquu : iou, oii, oui, qui, quo
bbmnrtt : mtn, tnt, trt
aaaeioo : aaa, iao, oie
gnnqssv : gns, svgs, vss
aaaaaos : aaa, aas, asa, saa, sao
bghnrrv : brr, grr, nbg, rhb
biiuwwy : buy, ubi, ubii, wiwi
gghrvxy : ggr, gry, grx, hvy
aaaaefx : aaa, axe, fae, fax
efjjoqz : eof, fez, foe, jef, joe
eeioouu : iou, oie, oui
beeeeef : bee, beef, bef, fee, feeb
clvwwyz : cyl, cly, lyc
efuvwxx : feu, few, vex, wef, xxv
aaaaadu : aaa, ada, aud, dau
llnnpvy : lyn, lynn, llyn, ply
iiiqsvv : iii, iqs, vii, viii, vis
aaaeeiz : aaa, zea, zee
eeeiiin : een, ieee, iii, nee, nei
glnnrss : gns, grs, lnr
aaaacee : aaa, ace, cee
fhijjlr : fil, fir, hir, lif, lir
eeeopuu : epee, ope, pee, poe, upo
dnrrssz : dsr, rnd, sds
giiiioo : gio, goi, goo, iii, oii
deooooo : doe, doo, edo, ode, oooo
dffjltw : dft, dwt, fld, fwd
ceeeeox : cee, coe, cox, eco, exec
cglsssw : cgs, csw, lsc
eeeouuy : eye, yee, yeo, yoe, you
ltuwwzz : lut, ult, wut
eftttvv : eft, fet, tef, vet
aaeeefq : aeq, fae, faq, fee, qaf
iiorrzz : oii, rio, roi, rori, zori
aefiiii : fae, fei, fie, ife, iii
jlssstt : lst, slt, tss, tst
knnrwyy : rwy, wyn, wynn, wry
aaiioox : aix, iao, ixia, oii, xii
bbmnrsz : bbs, mrs, rms
hllmrtz : ltr, mhz, tlr, tmh
iiijoov : iii, ijo, oii, vii, viii
hmnryyz : hymn, hny, hrzn, mhz, rhymy
iiqrruv : qui, riv, uri, vii
eioooqw : oie, owe, wei, woe, woo
bglmnrz : brl, glb, lnr, mgr, nbg
ddllnnr : dlr, lnr, rld, rnd
aeeeiqx : aeq, aix, axe, ieee
aaceeex : ace, axe, cee, exec
ceiiiiz : cie, cize, ice, iii
aaaeioq : aaa, aeq, iao, oie
bdjntyy : dyn, jnd, jnt, tynd
eeiiouu : iou, oie, oii, oui
dfgknqw : dkg, fgn, fwd, kgf
eeeegox : ego, gee, geo, gox, ogee
jllnnny : lyn, lynn, llyn
cdjquyy : cud, cuj, duc, jud, judy
gnnsxyz : gyn, gns, syn, sny, xyz
bdjnrvw : dbrn, jnd, rnd, rwd
kmnnrrs : krs, mks, mrs, rms
aaeeefo : eof, fae, fee, foe, oaf
iiijnrr : iii, jin, jiri, rin
iiijluw : iii, iiwi, lui, uji
aiiiooo : iao, iii, oii
eeeeouy : eye, yee, yeo, yoe, you
fijqtxy : fit, fix, fixt, qty, tji
eiiiooz : iii, oie, oii, ooze, zoo
aaceeeo : ace, cee, coe, eco, oca
bddlnnv : bdl, bld, blvd, dbl
eeeiiix : ieee, iii, xii, xiii
iioouuv : iou, oii, oui, vii
fgiiiiw : fig, gif, iii, iiwi, wig
cklnnrz : clk, clr, crl, kln, lnr
eiiioqx : iii, oie, oii, xii, xiii
gruvvvw : gur, guv, rug, vug, wur
fjrtttx : frt, tfr, trf, trt, txt
aiiijuy : ayu, iii, jai, jay, uji
cllllny : cyl, cly, lyc, lyn, llyn
ajjoquu : aquo, juju, qua, quo
iijlquw : jiqui, liq, lui, qui, uji
botvvvz : bot, bvt, obv, tob, tov
beeeiiu : bee, ieee, ubi, ubii
aaaouzz : aaa, azo, zoa, zuza
aeeeiiz : ieee, zea, zee
ghlwxxy : hgwy, hwy, hwyl, lxx, why
bgnnnry : gyn, gry, nbg
aaooouw : awa, woa, woo
eiiouuu : iou, oie, oii, oui
fgrrrtv : frt, grf, grr, tfr, trf
eeeenoq : een, eon, nee, neo, one
cnnrrsv : crs, rcvr, scr, svc
eeegiii : gee, gie, ieee, iii
ffgqstz : qts, sfz, stg
bhjllny : hny, lhb, lyn, llb, llyn
ccguvww : ccw, guv, vug
llnqsst : lst, qts, slt, tln, tss
bfjnntt : bnf, jnt, tnt
cgglnqr : clr, crl, ggr, lnr
djttuvv : jud, jut, juv, tut
blnnptx : bpt, btl, pbx, pnxt, tln
beeeeiu : bee, ieee, ubi
jklrttw : ltr, rtw, tkt, tlr, trt
eeeeett : tee, teet, teetee, tete
aaeeiqx : aeq, aix, axe
mqrrrsv : mrs, qrs, rms
jlmnpsz : jms, lpm, msl, sml, spl
eequuuw : ewe, que, queue, wee
fijooov : foo, ijo, iof, ofo, oof
cnqtwxy : ctn, cwt, qty, wyn
aoooqqz : azo, oozoa, zoa, zoo
bghlpqz : bhp, glb, gph, lhb
eeeoopu : epee, ope, pee, poe, upo
aaaeeij : aaa, ajee, jai, jee
eeooouy : eye, yee, yeo, yoe, you
eehuuuz : eheu, hee, hue, zee
aaiiooz : azo, iao, oii, zoa, zoo
aeeeeiy : aye, eye, yea, yee, ieee
eoouzzz : ooze, ouze, ouzo, zoo
eeeeemy : eye, eme, yee, mee
aaaaoov : aaa, ava, avo, ova
cllnnsw : csw, lsc, lwl
ggjnrsw : ggr, gns, grs
dghrrrt : grr, gtd, hgt, rhd, tdr
cffqtuv : ctf, cuff, cut, fut, tuff
bghknss : bkg, bks, bsh, gns, nbg
dknprzz : pdn, prn, rnd
bbfstvw : bbs, bsf, bvt, tbs
eeegooo : ego, gee, geo, goo, ogee
dhmprrr : mph, phr, rhd, rpm
aaeeefx : axe, fae, fax, fee
eeeennu : een, nee, nene, nun, unn
aoooovy : avo, avoy, yao, oooo, ova
gjjklrt : glt, kgr, ltr, tlr
deeeooo : dee, doe, doo, edo, ode
ghknrtv : hgt, kgr, nth, tgn, tng
lmnnqss : msl, mss, sml
aeeiiuz : eau, zea, zee
aaaeiio : aaa, iao, oie, oii
gghhrss : ggr, grs, hrs, shh, shr
djnnrsz : dsr, jnd, rnd
eeiiiux : iii, xii, xiii
aaaaeox : aaa, axe, oxea
bbcjmsx : bbs, bxs, jms
aaaioqz : aaa, azo, iao, zoa
dghmnnr : mgd, mgr, mhg, rhd, rnd
cccrttv : crc, ctr, rct, trt
fllnttw : fll, lwl, tln, tnt
dfiijjy : dif, fid, fiji, yid
glmnnsv : gns, msg, msl, sml
ghkltwx : glt, hgt, hwt, lgth
iiillrr : iii, ill, lir, rill
aaaeiqx : aaa, aeq, aix, axe
nnnnouu : non, nou, noun, nun, unn
fjlnnps : fps, plf, psf, spl
hhiioqw : hoi, how, ihi, oii, who
aeiiioq : aeq, iao, iii, oie, oii
aaaeiju : aaa, eau, jai, jeu, uji
aaeeeij : ajee, ieee, jai, jee
jqrruwy : jur, jury, rwy, wry, wur
fiiisyy : ifs, iii, yis
fghiivv : fig, ghi, gif, ihi, vii
aaeefuu : auf, eau, fae, fee, feu
flnnstv : lst, slt, tln
ddfmmrr : mfd, mfr, mmf, mmfd
ceeeefx : cee, exec, fec, fee
eegiiii : gee, gie, iii
aaioooy : iao, yao, iyo, yoi
bddgrwy : dry, gry, rwd, rwy, wry
egiuuuw : gie, gue, wei, wig
eeiiiuw : ewe, iii, iiwi, wee, wei
gklnntz : glt, kln, tgn, tln, tng
cgklnnx : clk, kln, xcl
ddfmrwx : fwd, mfd, mfr, mxd, rwd
gkkrrsv : grr, grs, kgr, krs
aaaaiiw : aaa, awa, iwa
hkllmwz : lwl, lwm, mhz, wmk
dghlnvx : gld, hld, ldg, lhd, lndg
bdfprxx : pbx, pfd, pfx, prf, rfb
emnvzzz : env, men, mev, zen
dfgjlyy : fld, fly, gld, ldg
afiiiio : iao, iii, iof, oaf, oii
hnrssvw : hrs, shr, vss, whr, whs
eeeeemz : eme, mee, mzee, zee, zeme
ghrrsvv : grr, grs, hrs, shr
jjkkrst : krs, stk, str, trs, tsk
bbnsttw : bbs, tbs, tnt, tst
dknrsvx : dks, dsr, krs, rnd
aaaahoq : aaa, aah, aha, aho, hao
mnnnpss : mss, sps, ssp
eoquuvz : ouze, que, quo, voe, zoque
eeeeiqy : eye, yee, ieee
ctuuuvw : cut, cwt, utu, wut
fiiijmy : fiji, iii, imi, jim
oooorrs : oooo, oos, ors, roo, ros
iillqrr : ill, liq, lir, rill
giiiijl : gil, iii, jig, lig
eeiioox : oie, oii, xii
llnptvx : pnxt, pvt, tln
dfhnpqv : pdn, pdq, pfd
agiiiqy : agy, gay, yagi, iii
ejoouuu : ejoo, jeu, joe
aafuuux : auf, aux, faux, fax
glnrrsw : gns, grr, grs, lnr
bepuuvz : buz, pub, zebu, zep
eeeeoqt : qto, tee, toe
bbfggnp : bnf, fgn, nbg, pfg
bglrsss : bls, brl, glb, grs, lbs
hhlrrsv : hrs, shh, shr
aaeeiiy : aye, eye, yea, yee
eeeeepp : epee, pee, peep, pep
efnvvvx : env, fen, nef, vex
iinryyy : yin, yirn, rin
aaafiiq : aaa, faq, qaf
joquuvx : juv, quo, vox
agiiiiu : aug, gau, iii
eefiiuu : fee, fei, feu, fie, ife
flnrrss : frs, lnr, rfs
nnrsstv : str, trs, tss, vss
bbfsttw : bbs, bsf, tbs, tst
iiiiorz : iii, oii, rio, roi, zori
ghnrrrs : gns, grr, grs, hrs, shr
cddhjmy : chm, cmd, hyd, myc
gghlltw : glt, hgt, hwt, lgth, lwl
gjnnqrt : jnt, qtr, tgn, tng
aaeeeux : aux, axe, eau, eaux
aeeeehx : axe, hae, hee, hex, hexa
eeeegii : gee, gie, ieee
aeeuuuz : eau, zea, zee
aeeeeey : aye, eye, yea, yee
fhiiuvz : fiz, hui, ihi, vii, viz
rrrsstw : rtw, str, trs, tss
gllmttt : glt, gtt, mgt, mtg, tgt
aaeeiox : aix, axe, iao, oie, oxea
aaaaipq : aaa, apa, pia
orrssss : ors, ros, ross, sos, soss
jlmrrtx : ltr, mlx, mtx, tlr
eeeeehn : een, hee, hen, nee
llmnrtv : lnr, ltr, mtn, tln, tlr
ijrrrwz : wir, wirr, wiz
fknrrtw : frt, rtw, tfr, trf, wrnt
fhhiiim : him, ihi, iii, imi
fnstttz : sfz, tnt, tst
aaiiiqw : awa, iii, iiwi, iwa
ggkmuxz : gum, guz, mug, mugg, mux
giiiiil : gil, iii, lig
hnquxyy : hny, hun, yuh, yun
ccdkrrx : cdr, crc, rcd
fhluuvv : flu, hulu, ulu
llmnsss : msl, mss, sml
errrvww : err, rev, rew, ver, wer
iiooorr : oii, rio, roi, roo, rori
eeeoouv : eve, evoe, vee, voe
cfgssxz : cfs, cgs, fcs, scf, sfz
bdhjnnt : bhd, jnd, jnt, nth
aafpuuu : apa, auf, pau, paua, pua
ggoooqy : gog, gogo, goy, goo, goog
blmnnnt : btl, mtn, tln
eiiijuu : iii, jeu, uji
aaffjuu : aff, affa, auf, ffa
cmnqvwy : cwm, myc, wyn
sttvyyy : sty, tyt, tst, tty
bffhkmr : mfr, rfb, rhb
aaejouu : eau, jeu, joe
iiiirvy : iii, ivy, riv, vii, viii
eefuuuv : eve, fee, feu, vee
bdnrssz : bds, dbrn, dsr, rnd, sds
mrrrtvy : myrt, tyr, tyrr, try
gnprrvw : grr, prn, pwr
eeegiiu : euge, gee, gie, gue, ieee
cceiiqw : ccw, cie, ice, wei, wice
iiinnry : iii, yin, yirn, inn, rin
chlnnpv : chn, cpl, hcl
nnqtuvz : nun, nut, tun, unn, untz
bcjlprz : brl, clr, cpl, crl, jcl
iiinrry : iii, yin, yirn, yirr, rin
bepuuww : pew, pub, web, wup
ceoooqx : coe, coo, cox, eco
djlrrrs : dlr, dsr, rld, sld
cglmnvz : cgm, cml, lcm, mcg
dpppuxx : dup, dux, ppd, pud, pup
lqttuvw : lut, tut, ult, wut
llllmss : msl, mss, sml
hlnuxxz : hun, lux, lxx, nul, unl
eeeiiox : ieee, oie, oii, xii
iirruuu : ruru, uri, uru
glnnnrs : gns, grs, lnr
flptvvw : lwp, plf, pvt, pwt, twp
eejjquu : jee, jeu, juju, que, queue
ceeeeiq : cee, cie, ice, ieee
iiilquu : iii, liq, lui, qui, ulu
ddhhijw : did, hhd, hid, whid, wid
aeeeequ : aeq, eau, qua, quae, que
cfiiiiu : cfi, cif, cuif, fuci, iii
eiiinuu : iii, nei, niue, uni, unie
innnrrv : inn, inv, rin, riv, vin
ftuuvww : fut, utu, wut
aeuuuww : awe, eau, wae, waw, wea
aaacoou : aaa, auca, coo, oca, uca
bcciiiw : ccw, iii, iiwi
aaaeeej : aaa, ajee, jee
fhhqruv : fur, huh, hurf, urf
cmrrrtw : ctr, cwm, cwt, rct, rtw
bbppuuu : bub, ppb, pub, pup
lnprvww : lnr, lwp, prn, pwr
aiooooy : iao, yao, iyo, yoi, oooo
eiiooux : iou, oie, oii, oui, xii
enoooqq : eon, neo, noo, one, ono
aeeeefo : eof, fae, fee, foe, oaf
cciijwx : ccw, wjc, xii
iirwyyz : rwy, wir, wiry, wiz, wry
bcggnpy : byp, cyp, gyn, gyp, nbg
egiiqxy : gey, gie, gye, yex, xii
mnrrrtw : mtn, rtw, wrnt
oooqrrz : roo, zoo, zorro
aaaiiux : aaa, aix, aux, ixia, xii
aeiooox : aix, axe, iao, oie, oxea
aaiiikq : aik, aka, akia, iii, kai
glmrrrw : grr, lwm, mgr
aaiiquu : aqua, qua, quai, qui, quia
hllrrtt : ltr, tlr, trt
knrrrst : krs, stk, str, trs, tsk
cddtvwx : cwt, ddt, dtd, dwt
effvyyz : eff, fey, fez, yez
gllrrsw : grr, grs, lwl
dhkprzz : kph, phr, rhd
aeeeiuz : eau, ieee, zea, zee
eeeeguu : euge, gee, gue
horrrvz : hor, ohv, rho, zho
cghllnp : chg, chn, cpl, gph, hcl
mpuuvvw : ump, umu, vum, wpm, wup
bmrrtwx : brr, mtx, rtw
eeeioux : ieee, iou, oie, oui
ggilqqx : gig, gil, lig, liq
aiiooqy : iao, yao, iyo, yoi, oii
fglllmr : fll, grf, mfg, mfr, mgr
ggmrvvx : ggr, grx, mgr
dmpqrrx : mxd, pdq, rpm
ajjoopq : jap, opa, poa, pooa
aaeeexz : axe, zax, zea, zee
bbcflnn : bbl, bcf, bnf, flb, lbf
knouuux : knox, kon, kou, nou, nox
eiiiiil : eli, iii, ile, lei, lie
eeiiooz : oie, oii, ooze, zee, zoo
bdhnsvx : bds, bhd, bsh, bxs
mnnntwy : mtn, wyn, wynn
crrrruu : cru, cur, curr, ruru, uru
ddpuuvz : dud, dup, pud, pudu
fghnrrw : fgn, grf, grr, whf, whr
aaeeeiy : aye, eye, yea, yee, ieee
jnppqtv : jnt, ppt, pptn, ptp, pvt
mnrrssw : mrs, mss, rms
fmssvvz : mss, sfm, sfz, vss
flpprrv : plf, ppl, ppr, prf, prp
fhjjlmu : flu, fum, hum, lum
iimqrrr : imi, mir, miri, rim
aaafiio : aaa, iao, iof, oaf, oii
cddlnnt : ctn, ddt, dtd, lcd, tln
eeeeiwx : ewe, ieee, wee, wei
bnrrtwz : brr, rtw, wrnt
bcgiiiq : big, cig, gib, iii
dgkkrvy : dkg, dry, gry, kgr, kyd
ghklmrx : grx, kgr, mgr, mhg, mlx
aaqqrrr : ara, arar, arr, rara
eeoqwzz : ewe, owe, wee, woe, zee
ffhpttv : fth, pht, ptt, pvt, tph
bknrwyz : yrbk, rwy, wyn, wry
dnprrrx : pdn, prn, rnd
fgglttt : glt, gtt, tgt
eiiiouu : iii, iou, oie, oii, oui
fhlnttt : fth, nth, tln, tnt
hllntww : hwt, lwl, nth, tln
gghkrrt : ggr, grr, hgt, kgr
iiruvvw : riv, uri, vii, wir, wur
aeeejjo : ajee, jee, joe
gllqqsy : lys, syl, syll, sly, sqq
cgllqsv : cgs, lsc, svc
glpprzz : ppl, ppr, prp
cnozzzz : con, coz, nco
aajqqvz : ava, java, qqv
eoooqvy : yeo, yoe, ovey, voe
aioooou : iao, iou, oooo, oui
fgiiiiu : fig, fug, gif, iii
eeeeeik : eke, ieee, ike, kee, kie
eegiiiu : euge, gee, gie, gue, iii
eeeeeop : epee, ope, pee, poe
aeiouuu : eau, iao, iou, oie, oui
aaeioou : eau, iao, iou, oie, oui
deiiiii : dei, die, ide, iii
aaeeoux : aux, axe, eau, eaux, oxea
aaaagiq : aaa, aga, gaia
bffhlnv : bnf, flb, lbf, lhb
eeeegiq : gee, gie, ieee
aaiouuu : iao, iou, oui
egooouu : ego, geo, goo, gou, gue
bdntwxy : dyn, dwt, tynd, wyn, wynd
eeiouxx : iou, oie, oui, xix, xxi
eeooopu : ope, pee, poe, upo
llmmrvy : lym, mym, rly
ghmnsww : gns, mhg, msg, whs
dmnnprr : pdn, prn, rnd, rpm
bbiuwxy : bib, bub, buy, ubi
aeeiooq : aeq, iao, oie
djnrrtz : jnd, jnt, rnd, tdr
aaiooqy : iao, yao, iyo, yoi
eiiijjt : iii, jet, jiti, tie, tji
iiiiiop : iii, oii, poi
aeejooo : ajee, ejoo, jee, joe
gqrtttz : gtt, qtr, tgt, trt
fghkknr : fgn, grf, kgf, kgr
gllnrss : gns, grs, lnr
iiijooq : iii, ijo, oii
bejqxyy : bey, bye, yex
eeeegwx : ewe, gee, wee
ciioouu : coo, iou, oii, oui
cnrrrsw : crs, csw, scr
fqtuvvy : fut, yuft, qty, tuy
eooouuz : ooze, ouze, ouzo, zoo
bhhlntv : btl, bvt, lhb, nth, tln
ggijjjp : gig, gip, jig, pig, pigg
gghhnvy : gyn, hny, hvy
hiiiixy : ihi, iii, xii, xiii
aiiiiwz : iii, iiwi, iwa, wiz
bjmnnpr : mpb, prn, rpm
nnntuvv : nun, nut, tun, unn
npryyzz : pyr, pry, prn
eeeeejm : eme, jee, jem, mee
ccdllwz : ccw, lcd, lwl
aaeiioq : aeq, iao, oie, oii
aaaceee : aaa, ace, cee
bglnsvz : bls, glb, gns, lbs, nbg
aaejoox : ajax, axe, ejoo, joe, oxea
eeeiyyy : eye, eyey, yee, ieee
hjkmnrt : jnt, mkt, mtn, nth, tmh
clllnps : cpl, cps, csp, lsc, spl
ggiiqyz : gig, gigi, zig
gklnqrx : grx, kgr, kln, lnr
llmpqtt : lpm, pmt, ptt, tpm
eeeoouy : eye, yee, yeo, yoe, you
ajoooow : jaw, jow, oooo, woa, woo
orsssss : ors, ros, ross, sos, soss
bdllltz : bdl, bld, btl, dbl, llb
aaaeeqz : aaa, aeq, zea, zee
eeeeoop : epee, ope, pee, poe
aaeejoo : ajee, ejoo, jee, joe
fhhittv : fit, fth, hit, tift, tit
cklmnnn : clk, cml, kln, lcm
blptttv : bpt, btl, bvt, ptt, pvt
dfjmpwy : fpm, fwd, mfd, pfd, wpm
nrrtxxy : rynt, tyr, tyrr, try
iooouuz : iou, oui, ouzo, zoo
eeqquvv : eve, qqv, que, vee, veuve
ciiimyz : icy, iii, imi, myc, zymic
eeennux : een, nee, nene, nun, unn
afgiiii : fag, fig, gif, iii
llnnppt : ppl, ppt, pptn, ptp, tln
flmrrvy : fly, fry, lym, mfr, rly
djnstvv : jnd, jnt, std
fgllnsx : fgn, fll, gns
eegiiiq : gee, gie, iii
aaciiiu : auca, cai, cia, iii, uca
bchmnqx : bch, chm, chmn, chn, hcb
nnqrtwz : qtr, rtw, wrnt
aajjllz : aal, ala, all, laz
dflrwwx : dlr, fld, fwd, rld, rwd
dgjnnsx : gds, gns, jnd, sgd
blmmrtt : brl, btl, ltr, tlr, trt
eeiooxx : oie, xix, xxi
aeiiiiy : aye, yea, iii
hiinqrr : hin, hir, ihi, rin
ceeiiiq : cee, cie, ice, iii
aiouuuz : azo, iao, iou, oui, zoa
iiooouu : iou, oii, oui
ennnqsv : ens, env, esq, sen, seq
gjlrrtz : glt, grr, ltr, tlr
aeeeeju : ajee, eau, jee, jeu
nnrsttt : str, tnt, trs, trt, tst
clnnrrr : clr, crl, lnr
eeeeiik : eke, ieee, ike, kee, kie
iinryyz : yin, yirn, nizy, rin
dhhhnrt : hhd, nth, rhd, rnd, tdr
hiinyyz : hin, hny, ihi, yin, nizy
eeiiiio : iii, oie, oii
blnqsww : bls, lbs, lbw
ffrrttw : frt, rtw, tfr, trf, trt
biiuyyz : biz, buy, buz, ubi, ubii
aiiqxyy : aix, yay, ixia, xii
dfhlnnn : fld, hld, lhd
iiinuyy : iii, yin, yun, uni
eiiooox : oie, oii, xii
aaaixyz : aaa, aix, xyz, zax
ffgllnp : fgn, fll, pfg, plf
aaaeejo : aaa, ajee, jee, joe
aaeeuxx : aux, axe, eau, eaux
ddnrrvy : dyn, dry, rynd, rnd
klnqttx : kln, tkt, tln, tnt, txt
blllnww : lbw, llb, lwl
aaaaiuw : aaa, awa, iwa
dllprxx : dlr, lxx, pdl, rld
aeiqqyy : aeq, aye, yay, yea
gkllrwx : grx, kgr, lwl
lnptvvw : lwp, pvt, pwt, tln, twp
lmmnrsv : lnr, mrs, msl, rms, sml
aaaiiio : aaa, iao, iii, oii
firrruv : fir, fur, riv, urf, uri
acccnxx : acc, anc, can, canc
fflrssv : frs, rfs, vss
beuuwwz : buz, web, wuzu, zebu
gmmmwyz : gym, myg, mym
cccequx : cue, ecu, que
ffrrtvx : frt, tfr, trf
eeioooz : oie, ooze, zee, zoo
dnnrrss : dsr, rnd, sds
abeeeeq : abe, aeq, bae, bea, bee
fgmnnsv : fgn, gns, mfg, msg, sfm
aeeejou : ajee, eau, jee, jeu, joe
djllryy : dlr, dry, dryly, rld, rly
acooouu : coo, oca, uca
beeiiqx : bee, ibex, xii
cllnrvv : clr, crl, lnr, vvll
eeeehzz : hee, heeze, zee
beiuuuw : ubi, web, wei
eeiooxz : oie, ooze, zee, zoo
glllrrt : glt, grr, ltr, tlr
aaeeejo : ajee, jee, joe
eeeeimy : eye, eme, yee, ieee, mee
aeeeoux : aux, axe, eau, eaux, oxea
aaeeuuz : eau, zea, zee
nruuuuy : yun, run, urn, uru
eiioouu : iou, oie, oii, oui
fllntyz : fly, fll, lyn, llyn, tln
cddlnqs : lcd, lsc, sdlc, sld, sqd
eeeeggh : egg, gee, ghee, gheg, hee
bflnnnp : bnf, flb, lbf, plf
cklnnvw : ckw, clk, kln
eeooquu : que, queue, quo
bcgrrrx : brr, brrr, grr, grx
djnrrtv : jnd, jnt, rnd, tdr
aaiijoo : iao, ijo, jai, jiao, oii
djpqszz : dsp, pdq, sqd